21333033033312021020131230320121111131201203213333123223311330102233020331030122
20020001131233201033300320311221213212023221211010020203223003102012203321113021
00212220132022221210200031311330221030321002132101300131002203230102102012200022
13121213131310021133021020231032310321013312213203120111303100313032303300212131
22232100310220031220230002313321101012101003102232000011331333221220230221123113
23033210101213020101322231003330000103300222201223012323133113330332312103223101
13303233211002101002331232030221302301100320030031313332101022201113032323211203
32131121033103222211031213311220220311130003313330122010212213001211013000222131
12102100021021103111100003132333230231301001102213100232113202323323331321320212
20100000121330221322003200112130202000212013322322232012023013101231020111012013
01221323330203302200023011111122003312120322231010113023333323222132320001023031
20213230302213301111220322200130011332320033213130120321003111023331232220110223
03010123011111311113231302213131110120020202312312310103100323332112202111220120
03323011012333030312001302200100212022012131030321103313103000220101100202201003
33123022120330313000132012303210133212130130202321311133110033223021012031003332
21231323211022012203031232230232313330000303220022001003212220213201102011112131
20113120023223323011300333121033220331201100230031021121130011322003012100120100
21213001310002100220220321001213023223032331322313011301013030213113211100013123
01200213001123021023032000330323311011111133222232012101203213031313300332200330
01123130321302212321000332022120132233200131321333330230313003003102222310322213
02101221113020020002210021012130033203321213201323331123003103113120101202023130
33010220121320013030331230122322022231120331002002122232002230212102312313002120
21230200100101132311230120310332011031221121103032033113122022002321200212310221
01233301013011223021001010231110121003222112131213033221230120011110020133300121
33210220123303201031211120111122310023321322111033123013030202112301123101312233
03320230100030111132333132030020113123032100232110022213110200313332200131213013
31100301302011012022032103201030311133323000313220021323313122300321233103121120
12033002111330223220330032221321112201113112320112122130012333222212030023330202
33201100303110211100103011132301112333332323300331021033201002101003222123213000
31112112302320111200302212202120132233320231323330003012311330331132032110032122
02102202012021311300303020333321301313001113102003122322300212112312313013213122
01320031112133302233120301002002313330002313302201312200033320101210232321232303
33303001220323233301321232031203220011112002130031003033323211311010000012001112
31211003321203232123100331310033331231233221033301033100123110111022031322031121
20013020013132300003330202012231002101223010323003113120323212212300102012022222
31102030233300023312333112221223003320111003013013021221313100120122133311123133
33032022303303110130313130100133123121203122332123001013131132012031131300113301
30322221320210313113200022320110202121003301200101020212003332221201322111232133
23311130123211313210302130103123211031120332022020123020220232111001202223023001
11330023311333323210300222323333133103322233021220000001222132203321301200310022
13100132232120002221323103331332220200130122310222330120113133100113303300202331
00312120030022022032331102020222303233320320022100211010312130030302222233002332
30230301130233132313010223011212123311231320231312103101303112312121203221110100
32011213101033231011110011102113322121121202210130333133020023310321132032301110
10203032203011322220030331121212210321321311220103311321012231110002213111310130
23012323302103222013002212123203221003131332133022202332103002131120222300312311
21313221210303133203313302230213001331333320111102000023210302120022322333232022
23012011010010313132332312032120332003123101033212313203003120200012201302010123
31310212030331221230220213200310312211210223311311122321132123030311321222123231
31030013002202023023020130110133333203210010020031020331233331023121313313210021
03112212213012330301100203122100021230131100303113111132112023031021210233310331
10201110111303300301132003301310203122332332121132222001011112220302210122110230
23110003323313033320233100321001330333211223011320223303210112022311022100121301
32300100132201213122310221003013312222330011302332212320210210221200112222331001
00012110032022013103323321301330230333003033210032323331302130110023031231011100
22103313311200131122103121211103112101021203233130023122220313020021213323311011
13330123332010303011201123223021132201102312011003123002313123311203202330322131
10322132021122200110132203331130100133302302201300032211133021122300002332003230
12030310312012111321031030331022223330233332122200010101310302302330130232331131
03123211233302221331132311223223023013303222210000110021331201022133310102112213
02011323012100010010330010103311331313110332000013122230231111002221310210131332
32313102331323231032303210322031233120012031123011220223331023132100102020133013
01112320330023120012110112232212302112301320212111333222033210113002300310110332
00113233020022020333232213123101322132030312300001312010020330302123332031330023
21202103302211231203121002113032121021013333213101021120212032230002301212320132
00323033233330110311012331300333330230002122003310322301021123130101112311001233
33011000333003003100203312230023033231310002300330310001323311113032212031320113
01021130000020130231101301311100001210300231101322220230023000303331310333023022
30023201003332031321000202323000032200320230311313032301232000030323120313333211
23331002111011122230223110210332112202200313202030001223330031211122211030203111
23231322223231311302323113030132022230321301122021332323301023210300222313221031
02330232010103120102222201321013130021022331000112110132221032302110311310212231
02231231230313030112133233201000333021022033231331331130213331120211121013130131
21110012202201022310111210022121330210320210012313023223122323330210230031120010
03213333122201132120321113201321122120213012001101312222010222033120332223130302
13311013003333220122031133120211003221130130022033130211103031131310113222300101
02003021120010200313123302033303131333102303311000301123221122021233001313131223
23100002331020033101230301311032302202233230123033201232131302313110312211203030
01100002010323221300102110123100023301113331103230331012212023103332011310223230
13303331200001021120302332303021111211103312121311000320230202221231030222120222